1e1111111111111111111
1*0*0*0*1*000*0*0*001
101111101011111101101
1*1*0*0*1*000*0*0*1*1
101001110000001110101
1*1*1*0*1*0*001*1*0*1
101010101011100000101
1*0*0*1*000*0*101*101
100110110110111010101
1*0*0*1*0*0*0*0*000*1
101111101001100010101
1*1*00001*0*0*1*001*1
101010011110000100101
100*0*0*0*0*0*1*0*1*1
101010101110001010101
1*10001*1*000*0*10101
100001101011001000101
1*100*001*10000*0*1*1
101011111000101011101
10100*0*0*1*0*0*000*1
1111111111111111111e1
