1e1111111111111111101
1*1*0*0*0*1*0*1*0*0*1
101011111010111111101
1*1*0*0*1*0*1*1*0*0*1
100000000000001000001
100111111111111110001
100000011100000000001
101111111111111110001
100000000000000000001
1*1*0*0*1*1*0*1*1*0*1
101010101011101011101
1*1*1*1*1*0*0*1*0*1*1
101010101110111101101
1*0*1*1*1*1*1*0*0*0*1
101010101010101111111
1*1*1*1*0*1*1*1*0*0*1
111010111110101110101
1*0*1*0*0*0*1*0*1*1*1
101111111111111010101
1*0*0*0*0*0*0*0*0*1*1
1011111111111111111e1