1e1111111111111111111
101*0*0*100*0*0*000*1
100001100011100001001
1*0*0*000*1*1*0*101*1
111010111010100010101
10001000001*0*0*0*1*1
101010111111111000001
100*000*0*0*0*101*101
101011001001101010101
10000*0*1*0*00001*1*1
101110101111110000101
101*0010000*0*1*0*1*1
101010111111001010001
1*1*1*000*0*0*101*001
101011110011111001111
1*0*0*001*0*0*100*0*1
101101000011101010001
1*0*00000*0*0*0000101
101110000100100100101
100*000*001*0*0*0*0*1
1111111111111111111e1
