1e1111111111111111111
100*0*000*0*1*000*0*1
110111011010100101101
1*0*0*000*1*1*0*0*101
101000110010111110001
1*0*1*0*1*0*0*100*1*1
100011100011101011101
1*000*1*100*0*001*101
111011000110110100101
1*0*1*0*1*0*000*000*1
111100111010111010101
1*000*1*0*1*00001*0*1
100101001010111111101
101*000*100*1*0*001*1
101010100100101110101
101*0*1*0*1*001*1*0*1
101010111010101001111
1*0*1*000*0*1*0*0*0*1
101000101111101110101
1*0*0*000*0000000*101
1111111111111111111e1
