1e1111111111111111111
100*1000000*000*0*0*1
111010111010111111101
101*0*1*0*1*10000*0*1
101110100010001111101
1*0*0*000*001*00100*1
100111000111111010111
1*100*0*100*000*001*1
101101111010110010101
1*100*0*0*100*000*101
100011110110001010101
1*1*0*0*000*0*1*001*1
100110100000101011001
1*0*0*100*000*0*0*0*1
100111101100001011101
1*0*1*0*1*0*00000*1*1
111010111011111101101
100*1*1*001*0*0*0*1*1
101110110100111100101
1*00100*000*0*0*100*1
1111111111111111111e1
