1e1111111111111111101
1*1*0*0*0*1*0*1*0*0*1
101011111010111111101
1*1*0*1*1*0*1*1*0*0*1
100000100000001000001
100111111011111110001
100000111000000000001
101111111011111110001
100000100000000000001
1*1*0*1*101*0*1*1*0*1
101010101011101011101
1*1*1*1*100*0*1*0*1*1
101010101010111101101
1*0*1*1*101*1*0*0*0*1
101010101010101111111
1*1*1*1*001*1*1*0*0*1
111010111010101110101
1*0*1*0*000*1*0*1*1*1
101111111011111010101
1*0*0*0*000*0*0*0*1*1
1011111111111111111e1