1e1111111111111111111
1*0*0*0*0*00000*0*0*1
110101111001110111101
100*0*0*100*0*0*0*0*1
100111101000111000101
1*0*1*1*1*101*0*0*0*1
100010100000001111101
1*0*1*001*101*1*0*1*1
101110111010101010001
100*1*0*0*10000*1*0*1
101001100100100010111
10101*0*0*1*0*1000001
111010110010001011101
1*0*10000010000*001*1
100110101010101010101
101*0*0*001*1*1*0*001
101001110010101011101
1*1*0*000*0*0*0*0*0*1
101101001001101100001
100*0*0*000*0*0*0*0*1
1111111111111111111e1
